Species	Common_names
Catagonus_wagneri	Chacoan peccary
Procavia_capensis	South Africanrock hyrax
Galeopterus_variegatus	Sunda flying lemur
Hippopotamus_amphibius	Hippopotamus
Manis_tricuspis	Tree pangolin
Moschus_moschiferus	Siberian musk deer
Antilocapra_americana	Pronghorn
Diceros_bicornis	Black rhinocerous
Tragulus_javanicus	Java lesser chevrotain
Hemitragus_hylocrius	Nilgiri tahr
Acomys_cahirinus	Cairo spiny mouse
Allactaga_bullata	Gobi jerboa
Alouatta_palliata_mexicana	Mexican howler monkey
Anoura_caudifer	Tailed tailless bat
Aplodontia_rufa	Mountain beaver
Artibeus_jamaicensis	Jamacian fruit-eating bat
Ateles_geoffroyi	Geoffroy's spider monkey
Beatragus_hunteri	Hirola
Callicebus_donacophilus	White-eared titi
Capromys_pilorides	Desmarest's hutia
Carollia_perspicillata	Seba's short-tailed bat
Castor_canadensis	North American beaver
Cavia_tschudii	Montane guinea pig
Cebus_albifrons	White-fronted capuchin
Ceratotherium_simum_cottoni	Northern white rhino
Cercopithecus_neglectus	De brazza's monkey
Chaetophractus_vellerosus	Screaming hairy armadillo
Cheirogaleus_medius	Fat-tailed dwarf lemur
Choloepus_didactylus	Linnaeus's two toed sloth
Chrysochloris_asiatica	Cape golden mole
Craseonycteris_thonglongyai	Bumblebee bat
Cricetomys_gambianus	Gambian pouched rat
Crocidura_indochinensis	Indochinese shrew
Cryptoprocta_ferox	Fossa
Ctenodactylus_gundi	Common gundi
Ctenomys_sociabilis	Social tuco-tuco
Cuniculus_paca	Lowland paca
Dasyprocta_punctata	Central American agouti
Daubentonia_madagascariensis	Aye-aye
Dinomys_branickii	Pacarana
Dipodomys_stephensi	Stephen's kangaroo rat
Dolichotis_patagonum	Patagonian mara
Erythrocebus_patas	Patas monkey
Eschrichtius_robustus	Grey whale
Eubalaena_japonica	North pacific right whale
Eulemur_fulvus	Common brown lemur
Felis_nigripes	Black-footed cat
Glis_glis	Edible dormouse
Graphiurus_murinus	Woodland doormouse
Helogale_parvula	Dwarf mongoose
Heterohyrax_brucei	African yellow-spotted rock hyrax
Hipposideros_galeritus	Cantor's leaf-nosed bat
Hyaena_hyaena	Striped hyena
Hydrochoerus_hydrochaeris	Capybara
Hystrix_cristata	Northern crested porcupine
Indri_indri	Indri
Inia_geoffrensis	Amazon river dolphin
Kogia_breviceps	Pygmy sperm whale
Lasiurus_borealis	Eastern red bat
Lemur_catta	Ring tailed lemur
Lepus_americanus	Snowshoe hare
Macroglossus_sobrinus	Long-tongued fruit bat
Megaderma_lyra	Greater false vampire bat
Mellivora_capensis	Honey badger
Meriones_unguiculatus	Mongolian jird
Mesoplodon_bidens	Sowerbyâ€™s beaked whale
Microgale_talazaci	Talazac's shrew tenrec
Micronycteris_hirsuta	Hairy big-eared bat
Miniopterus_schreibersii	Common bent-wing bat
Mirounga_angustirostris	Northern elephant seal
Mirza_coquereli	Coquerel's giant mouse lemur
Monodon_monoceros	Narwhal
Mormoops_blainvillei	Ghost-faced bat
Mungos_mungo	South Africanbanded mongoose
Murina_feae	Ashy-gray tube-nosed bat
Muscardinus_avellanarius	Hazel dormouse
Myocastor_coypus	Coypu
Myotis_myotis	Greater mouse-eared bat
Myrmecophaga_tridactyla	Giant anteater
Nasalis_larvatus	Proboscis monkey
Noctilio_leporinus	Greater bulldog bat
Nycticebus_coucang	Sunda slow loris
Ondatra_zibethicus	Muskrat
Onychomys_torridus	Scorpion mouse
Orycteropus_afer	Aardvark
Ovis_canadensis_cremnobates	Peninsular bighorn sheep
Panthera_onca	Jaguar
Paradoxurus_hermaphroditus	Asian palm civet
Perognathus_longimembris_pacificus	Pacific pocket mouse
Petromus_typicus	Dassie rat
Phocoena_phocoena	Harbor porpoise
Pipistrellus_pipistrellus	Common pipistrelle
Pithecia_pithecia	White-faced saki
Platanista_gangetica	Indus river dolphin
Pteronura_brasiliensis	Giant otter
Pygathrix_nemaeus	Red-shanked douc
Rangifer_tarandus	Siberian reindeer
Rousettus_aegyptiacus	Egyptian fruit bat
Saguinus_imperator	Emperor tamarin
Saiga_tatarica	Russian saiga
Scalopus_aquaticus	Eastern mole
Semnopithecus_entellus	Northern plains gray langur
Sigmodon_hispidus	Hispid cotton rat
Solenodon_paradoxus	Hispaniolan solenodon
Spilogale_gracilis	Western spotted skunk
Suricata_suricatta	Meerkat
Tadarida_brasiliensis	Mexican free-tailed bat
Tamandua_tetradactyla	Southern tamandua
Tapirus_indicus	Malayan tapir
Tapirus_terrestris	South American tapir
Thryonomys_swinderianus	Greater cane rat
Tolypeutes_matacus	Southern three-banded armadillo
Tonatia_saurophila	Stripe-headed round-eared bat
Tupaia_tana	Large treeshrew
Uropsilus_gracilis	Gracile shrew-like mole
Vulpes_lagopus	Arctic fox
Xerus_inauris	Cape ground squirrel
Zalophus_californianus	California sea lion
Zapus_hudsonius	Meadow jumping mouse
Ziphius_cavirostris	Cuvier's beaked whale
Echinops_telfairi	Small Madagascar hedgehog
Dicerorhinus_sumatrensis	Sumatran rhinoceros
Acinonyx_jubatus	Cheetah
Ailuropoda_melanoleuca	Giant panda
Ailurus_fulgens	Lesser panda
Ammotragus_lervia	Aoudad
Aotus_nancymaae	Ma's night monkey
Balaenoptera_acutorostrata	Minke whale
Balaenoptera_bonaerensis	Antarctic minke whale
Bison_bison	American bison
Bos_indicus	Zebu cattle
Bos_mutus	Wild yak
Bos_taurus	Cattle
Bubalus_bubalis	Water buffalo
Callithrix_jacchus	White-tufted-ear marmoset
Camelus_bactrianus	Bactrian camel
Camelus_dromedarius	Arabian camel
Camelus_ferus	Wild bactrian camel
Canis_lupus_familiaris	Dog
Capra_aegagrus	Wild goat
Capra_hircus	Goat
Cavia_aperea	Brazilian guinea pig
Cavia_porcellus	Domestic guinea pig
Cebus_capucinus	White-faced sapajou
Ceratotherium_simum	Southern white rhinoceros
Cercocebus_atys	Sooty mangabey
Chinchilla_lanigera	Long-tailed chinchilla
Chlorocebus_sabaeus	Green monkey
Choloepus_hoffmanni	Hoffmann's two-fingered sloth
Colobus_angolensis	Angolan colobus
Condylura_cristata	Star-nosed mole
Cricetulus_griseus	Chinese hamster
Dasypus_novemcinctus	Nine-banded armadillo
Delphinapterus_leucas	Beluga whale
Desmodus_rotundus	Common vampire bat
Dipodomys_ordii	Ord's kangaroo rat
Eidolon_helvum	Straw-colored fruit bat
Elaphurus_davidianus	Pere david's deer
Elephantulus_edwardii	Cape elephant shrew
Ellobius_lutescens	Transcaucasian mole vole
Ellobius_talpinus	Northern mole vole
Enhydra_lutris	Sea otter
Eptesicus_fuscus	Big brown bat
Equus_asinus	Ass
Equus_caballus	Horse
Equus_przewalskii	Przewalski's horse
Erinaceus_europaeus	Western European hedgehog
Eulemur_flavifrons	Sclater's lemur
Felis_catus	Cat
Fukomys_damarensis	Damara mole-rat
Giraffa_tippelskirchi	Giraffe
Gorilla_gorilla	Western lowland gorilla
Heterocephalus_glaber	Naked mole-rat
Hipposideros_armiger	Great roundleaf bat
Homo_sapiens	Human
Ictidomys_tridecemlineatus	Thirteen-lined ground squirrel
Jaculus_jaculus	Lesser Egyptian jerboa
Leptonychotes_weddellii	Weddell seal
Lipotes_vexillifer	Yangtze river dolphin
Loxodonta_africana	African savanna elephant
Lycaon_pictus	African hunting dog
Macaca_fascicularis	Crab-eating macaque
Macaca_mulatta	Rhesus monkey
Macaca_nemestrina	Pig-tailed macaque
Mandrillus_leucophaeus	Drill
Manis_javanica	Malayan pangolin
Manis_pentadactyla	Chinese pangolin
Marmota_marmota	Alpine marmot
Mesocricetus_auratus	Golden hamster
Microcebus_murinus	Gray mouse lemur
Microtus_ochrogaster	Prairie vole
Miniopterus_natalensis	Bats
Mus_caroli	Ryukyu mouse
Mus_musculus	House mouse
Mus_pahari	Shrew mouse
Mus_spretus	Western wild mouse
Mustela_putorius	Domestic ferret
Myotis_brandtii	Brandt's bat
Myotis_davidii	Bats
Myotis_lucifugus	Little brown bat
Nannospalax_galili	Upper Galilee Mountains blind mole rat
Neomonachus_schauinslandi	Hawaiian monk seal
Neophocaena_asiaeorientalis	Yangtze finless porpoise
Nomascus_leucogenys	Northern white-cheeked gibbon
Ochotona_princeps	American pika
Octodon_degus	Degu
Odobenus_rosmarus	Pacific walrus
Odocoileus_virginianus	White-tailed deer
Okapia_johnstoni	Okapi
Orcinus_orca	Killer whale
Oryctolagus_cuniculus	Rabbit
Otolemur_garnettii	Small-eared galago
Ovis_aries	Sheep
Pan_paniscus	Pygmy chimpanzee
Pan_troglodytes	Chimpanzee
Panthera_pardus	Leopard
Panthera_tigris	Amur tiger
Pantholops_hodgsonii	Chiru
Papio_anubis	Olive baboon
Peromyscus_maniculatus	Prairie deer mouse
Piliocolobus_tephrosceles	Ugandan red colobus
Pongo_abelii	Sumatran orangutan
Propithecus_coquereli	Coquerel's sifaka
Psammomys_obesus	Fat sand rat
Pteronotus_parnellii	Parnell's mustached bat
Pteropus_alecto	Black flying fox
Pteropus_vampyrus	Large flying fox
Puma_concolor	Puma
Rattus_norvegicus	Norway rat
Rhinolophus_sinicus	Chinese rufous horseshoe bat
Rhinopithecus_bieti	Black snub-nosed monkey
Rhinopithecus_roxellana	Golden snub-nosed monkey
Saimiri_boliviensis	Bolivian squirrel monkey
Sorex_araneus	European shrew
Spermophilus_dauricus	Daurian ground squirrel
Sus_scrofa	Pig
Trichechus_manatus	Florida manatee
Tupaia_chinensis	Northern tree shrew
Tursiops_truncatus	Bottlenose dolphin
Ursus_maritimus	Polar bear
Vicugna_pacos	Alpaca
Antrozous_pallidus	Pallid bat
Bradypus_variegatus	Brown-throated sloth
Macrotus_californicus	California leaf-nosed bat
Nycticeius_humeralis	Egyptian slit-faced bat
Pedetes_capensis	South Africanspringhare
Pontoporia_blainvillei	La Plata dolphin
Rhinolophus_ferrumequinum	Greater horseshoe bat
Rhizomys_pruinosus	Hoary bamboo rat
Apaloderma_vittatum	Bar-tailed trogon
Buceros_rhinoceros	Rhinoceros hornbill
Colius_striatus	Speckled Mousebird
Leptosomus_discolor	Cuckoo-roller
Cariama_cristata	Red-legged seriema
Falco_peregrinus	Peregrine falcon
Haliaeetus_leucocephalus	Bald eagle
Taeniopygia_guttata	Zebra finch
Aptenodytes_forsteri	Emperor penguin
Chlamydotis_macqueenii	MacQueen's bustard
Fulmarus_glacialis	Northern fulmar
Pelecanus_crispus	Dalmatian pelican
Phalacrocorax_carbo	Great cormorant
Antrostomus_carolinensis	Chuck-will's-widow
Columba_livia	Domestic pigeon
Phoenicopterus_ruber	American flamingo
Pterocles_gutturalis	Yellow-throated sandgrouse
Cairina_moschata	Muscovy duck
Gallus_gallus	Chicken
Meleagris_gallopavo	Wild turkey
Ficedula_albicollis	Collared flycatcher
Naja_naja	Indian cobra
Thamnophis_elegans	Western garter snake
Crotalus_viridis	Prairie rattlesnake
Lacerta_viridis	European green lizard
Lacerta_bilineata	Western green lizard
Lacerta_agilis	Sand lizard
Podarcis_muralis	Common wall lizard 
Vipera_berus	European adder
Anseranas_semipalmata	Magpie goose
Bucorvus_abyssinicus	Northern ground hornbill
Calidris_pugnax	Ruff
Chionis_minor	Black-faced sheathbill
Cuculus_canorus	Common cuckoo
Egretta_garzetta	Little egret
Falco_cherrug	Saker falcon
Nipponia_nippon	Crested Ibis
Halcyon_senegalensis	Woodland kingfisher
Ibidorhyncha_struthersii	Ibisbill
Lophotis_ruficrista	Red-crested bustard
Numida_meleagris	Helmeted guineafowl
Nycticryphes_semicollaris	Painted-snipe
Parus_major	Great tit
Penelope_pileata	White-crested guan
Psophia_crepitans	Grey-winged trumpeter
Pterocles_burchelli	Burchell's sandgrouse
Trogon_melanurus	Black-tailed trogon
Laticauda_laticaudata	Blue-lipped sea krait
Pseudonaja_textilis	Eastern brown snake
Notechis_scutatus	Tiger snake
Pantherophis_obsoletus	Western rat snake
Pantherophis_guttatus	Corn snake
